Words:

date - "свидание"
wierd - странно
tie - завязывать
familiar - знакомый, похожий
decision - решение
horrible - ужасный
suppose - предполагать
that's it - и все
honest - честно
spit on - плевать на
although - однако, хотя
thats how - вот как, таким образом
unless - только если
hangover - похмелье
sophisticated - утонченный, сложный






Phrases:

in my case - в моем случаи
it matters - это важно
all of a sudden  - вдруг
i wish i could, but i dont want to - я бы хотел, только неохота
how did you get through it - как ты с этим справился
it doesn't make much of a difference - Это не имеет большого значения(никто и не заметит)
stay out of - держись подальше от 

i'm trained for nothing - я ничего не умею
i was laughed out - надо мной посмеялись, был осмеян
being on your own - самостоятельно
split it up - разделить
you probably didn't know this - возможно ты не знал






Other:
